11
############
#          #
# OXP ######
#          #
#####      #
# O ##     #
#   ##     #
#          #
#        X #
#        # #
############